g g g x x x x x x x
g g g x x x x x x x
g g g x x | | | x x
g g g x x | x x x x
g g g x x | x x x x
g g g x x | x a x x
g g g x x | x x x x
g g g x x | | | x x
g g g x x x x x x x
g g g x x x x x x x