x x x x x x x x x x
x x x x x x x x x x
x x x x x | | | x x
x x x x x | x x x x
x x x x x | x x x x
x x x x x | x a x x
x x x x x | x x x x
x x x x x | | | x x
x x x x x x x x x x
x x x x x x x x x x